tntl=trying not to laugh
prt=party
gn=good night
fimh=forever in my heart
atm=at the moment
qpsa=que pasa
cul8r=see you later
iow=in other words
idc=i don’t care
prw=parents are watching
atk=at the keyboard
oic=oh i see
icq=i seek you 
fyi=for your information
ldr=long distance relationship
bfn=bye for now
mte=my thoughts exactly
ily=i love you
g9=genius
rofl=rolling on the floor laughing
u4e=yours for ever
roflcopter=rolling on the floor laughing wildly
wtg=way to go
asap=as soon as possible
mfw=my face when
b4=before
dm=direct message
m8=mate
sk8=skate
nvm=never mind
bae=before anyone else
rofllol=rolling on the floor laughing out loud
jk=just kidding
stats=your sex and age
ilu=i love you
imho=in my honest/humble opinion
pita=pain in the ass
omw=on my way
u=you
gmta=great minds think alike
irl=in real life
bak=back at keyboard
thx=thank you
ttfn=ta ta for now
ifyp=i feel your pain
asl=age sex location
smh=shaking my head
tfw=that feeling when
bsaaw=big smile and a wink
imu=i miss you
gr8=great
btw=by the way
u2=you too
afaik=as far as i know
gal=get a life
np=no problem
adih=another day in hell
ttyl=talk to you later
bwl=bursting with laughter
nrn=no reply necessary
l8r=later
brb=be right back
zzz=sleeping, bored, tired
afk=away from keyboard
wb=welcome back
gg=good game
bff=best friends forever
cu=see you
fomo=fear of missing out
w8=wait
cya=see you
ltns=long time no see
faq=frequently asked questions
kiss=keep it simple stupid
tbh=to be honest
hmu=hit me up
7k=sick
bbs=be back soon
lmao=laugh my ass off
brt=be right there
wywh=wish you were here
fwiw=for what it's worth
csl=can’t stop laughing
fc=fingers crossed
imo=in my opinion
idk=i don't know
time=tears in my eyes
rotflmao=rolling on the floor laughing my ass off
bbl=be back later
b4n=bye for now
ic=i see
lol=laughing out loud
wuf=where are you from?
a3=anytime anywhere anyplace
mrw=my reaction when
